HELLO = "Hallo Welt"
EXIT_QUESTION = "Space Invader beenden?"
CONFIRM_EXIT = "Beenden bestaetigen"
SEARCHING_SOUNDFILES = "Suche nach Sound Dateien..."
LOADING_SOUNDFILES = "Lade Sounds..."
LOADING_IMAGES = "Lade Grafiken..."
READY = "Bereit"
OPTIONS = "Optionen"
LANGUAGE = "Sprache"
INPUTCONFIG = "Steuerung"
CLEARLOGS = "Logs loeschen"
RESET = "Zuruecksetzen"
ENEMY_KILLED = "Feindliches Schiff zerstoert."
ALLY_KILLED = "Verbuendetes Schiff zerstoert."
ENEMYLEFT = "Gegner uebrig"
ENEMYSLEFT = "Gegner uebrig"
GAMEOVER = "SPIELENDE"
PAUSED = "PAUSIERT"
LEVEL = "Level"
LEVEL_START = "Starte Level"
HUNTERAPPROACH = "Feindliche Jaegerstaffeln im Anflug!"
LEVEL_COUNTDOWN = "Naechste Welle startet in "
LEVEL_FINISHED = "Alle erledigt."
PRESS = "Druecke"
TOLAND = "zum Landen."
NOT_IN_LZONE = "Sie befinden sich nicht in einer Landezone."
LOST_IN_SPACE_WARNING = "Verlier dich nicht im Weltraum."
ORDER_FOLLOW = "Befehl zu folgen erteilt"
ORDER_STAY = "Befehl zu bleiben erteilt"
FLEET_EMPTY = "Keine Flotte zu befehligen"
FRAMERATE_WARNING = "Achtung: Bildrate ist zu hoch"
MOTHERSHIPAPPROACH = "Ausserirdisches Mutterschiff gesichtet!"
EARNED = "Sie erhalten"
LOST = "Sie verlieren"
CURRENCY_SINGULAR = "Backstein"
CURRENCY_PLURAL = "Backsteine"
SCORE = "Geld"
LIFTOFF = "Abheben"
BUY = "Kaufen"
BUYSHIP = "Neues Schiff kaufen"
CLASS = "Klasse"
HITPOINTS = "Lebensenergie"
HP = "LE"
SPEED = "Geschwindigkeit"
ROTSPEED = "Drehgeschwindigkeit"
ACCEL = "Beschleunigung"
MAINWEAPON = "Hauptwaffe"
NOTENOUGH = "Nicht genug"
ADDTOFLEET = "zur Flotte hinzugefügt"
FIGHTER = "Kampfschiff"
HUNTER = "Abfangjaeger"
WINGMAN = "Fluegelmann"
CRUISER = "Kreuzer"
CARRIER = "Traegerschiff"
SQUADRON = "Geschwader"
ASSIGN = "Ausruesten"
ASSIGNED = "Ausgeruestet"
SHIP = "Mein Schiff"
FLEET = "Flotte"